1,1,1,1,1,1,1,1
1,1,1,D,1,1,1,1
1,1,1,1,1,1,1,1
1,1,1,1,1,1,1,1
1,1,1,1,1,1,1,1
1,1,1,1,1,1,1,1
1,1,1,UD,1,1,1,1
1,1,1,1,1,1,1,1